11111111
1E0C0P01
10000001
10000001
10000001
11111111